42
42
111111111111111111111111111111111111111111
122221122221122221122221122221122221122221
123321123322123322123322123322123322123322
124511122222222222222222222222222222211111
122222222422222222222222222222222222211111
111122233333333443344443343333333333221111
111122233344444444444444444444434343221111
122222233444555555555555555444433343221111
123322233344556666666666555444434333221111
124522233444555688886666555444434343221111
122222233344556689888666655544443334322111
111122233344556688886666444444434333221111
111122233444556677776666343433333314221111
122222233334556677776666343333344341221111
123322333334556677776666343222221121211111
124522333434555577773333333222222121112111
122122333334444477774444433222132222211111
111222333334545577775544434233221221211111
112222333444445675776544433222322122212111
121222333344455677576544435222322221211111
123322333334445677776544434233121222121111
124522334344455677776544433452222222221111
122222333334455677776544435222322421211114
111122334334445555555555534353422221211111
111122234334444444555555544444322222121111
122222233333333344555555544434322222211211
123322333333333344555555534444322222211111
124522333333333344555555544444322222211111
122222333333444444555555543434322221241211
111122333333446665666555533222222222211111
111122323333446858866555533222222221112111
122222333333445899866555534222222121111111
123322333333446588866555533222222111112111
124532333333446666566555533222222111111111
122221323333444444444443433222222111112111
111111322333333433343333333222222141111111
111112232222233333333333333222212121241111
122221222222222242222222222222212141111111
123322222222242222222224222222112121121111
124532222222222224222222221221222141111111
122221122221122221122211122211422221222221
111111111111111112111111111111111111111111